xxxxxxxxxxxxxxxxxxx
x--x-----------x--x
x--x-----------x--x
x--x-----------x--x
x-----------------x
x-p-------------b-x 
x-----------------x
x--x-----------x--x
x--x-----------x--x
x--x-----------x--x
xxxxxxxxxxxxxxxxxxx
